NO ./textures/wall_north.xpm
SO ./textures/wall_south.xpm
WE ./textures/wall_west.xpm
EA ./textures/wall_east.xpm

F 220,100,0
C 135,206,235

1111111111111111
1000000000000001
1010101010101001
1010000000101001
1010000N00101001
1010101010101001
1000000000000001
1111111111111111