NO     ./textures/stone_wall.png
SO ./textures/tile_wall.png     
WE ./textures/brick_wall.png
EA ./textures/stone_wall2.png
F 220,100,0
C 250,250,250

111111
100101
101001

111111