NO ./textures/stone_wall.png
SO ./textures/tile_wall.png
WE ./textures/brick_wall.png
EA ./textures/palisade.png
F 14,200,30
C 135,206,235

1111111111111111
1000000000000001
1010101010101001
1010000100101001
1010000N00101001
1010101010101001
1000000000000001
1111111111111111
