NO ./textures/stone_wall2.png
SO ./textures/tile_wall2.png
WE ./textures/brick_wall2.png
EA ./textures/stone_wall3.png
F 14,200,30
C 135,206,235

1111111111111111
1000000000000001
1010101010101001
1010000000101001
1010000N10101001
1010101010101001
1000000000000001
1111111111111111
