NO     ./textures/stone_wall.xpm


SO ./textures/wood_wall.xpm     
WE ./textures/brick_wall.xpm
EA ./textures/palisade.xpm




F    220,       100,0
C 250,  250,250

111111
100101
101001
1100N1
111111
