NO ./path_texture
SO ./path_texture
WE ./path_texture
EA ./path_texture
F 220,100,0
C 250,250,250

111111
100101
10 001
1100N1
111111