NO ./textures/wall_north.xpm
SO ./textures/wall_south.xpm
WE ./textures/wall_west.xpm
EA ./textures/wall_east.xpm
F 220,100,0
C 250,250,250

111111
1001001
101001
1100N1
111111