NO ./textures/wall_north.png
SO ./textures/wall_south.png
WE ./textures/wall_west.png
EA ./textures/wall_east.png

F 220,100,0
C 250,250,250

111111
100S01
101001
1100N1
111111