NO ./textures/brick_wall.png
SO ./textures/stone_wall.png
WE ./textures/stone_wall2.png
EA ./textures/tile_wall.png

F 0, 128, 0
C 0, 191,           255

        1111111111111111111111111
        1000000000110000000000001
        1011000001110000000000001
        1001000000000000000000001
111111111011000001110000000000001
100000000011000001110111111111111
11110111111111011100000010001
11110111111111011101010010001
  110000001101010111000000101111
1110000000S000001100000010001
10000000000000001101010010001
1100000111010101111101111000111
11110111111101011101111010001
11111111111111111111111111111
