NO ./textures/stone_wall.png
SO ./textures/gotic_window.png
WE ./textures/dark_forest.png
EA ./textures/quartz.png
F 76, 45, 42
C 25, 25, 112


111111111111111111111
1000000000C0011000001
101111011111011011101
100C01010001000010001
111101010101111010111
100001010100001010001
101101110111101011101
10010000000C001000001
111101111101111011101
10000100000100000C001
101101011101011111101
1000000100010000000E1
111111111111111111111
