NO ./textures/stone_wall.png
SO ./textures/gotic_window.png
WE ./textures/dark_forest.png
EA ./textures/quartz.png
F 236, 103, 0
C 80, 17, 71

1111
1001
1E01
1011
1001
1001
10011
10001
11111