NO ./textures/stone_wall.png
SO ./textures/gotic_window.png
WE ./textures/dark_forest.png
EA ./textures/quartz.png
F 236, 103, 0
C 80, 17, 71

111111
10C001
100001
10N011
1000C1
101101
100101
100001
111111