


111111111111111111111
100000000000011000001
101111011111011011101
100001010001000010001
111101010101111010111
100001010100001010001
101101110111101011101
100100000000001000001
111101111101111011101
100001000001000000001
101101011101011111101
1000000100010000000E1
111111111111111111111
