NO ./textures/altamira.png
SO ./textures/snake.png
WE ./textures/dark_forest.png
EA ./textures/stonhenge.png
F 72, 61, 139
C 25, 25, 112

111111111111111111111
100000000011000000001
101100000111000000001
100100000000000000001
111111111011000001111
    10000000001100001111
111111111111110111101       
111101000000000111101
111101011111110111101
100001010000010100001
101101011101010111101
1000000000W0000000001
111111111111111111111

